AAAAAAAAAAAAAAAAAAAAAAAAAAAAAAAAAAAAAAAA
A                                      A
A                                      A
APPPPPPPPPPPPPPPPPPPPPP                A
A                                      A
A                                      A
A                                      A
A                                      A
A      PPPPPPPPPPPPPPPPPPPPPPPPPPPPPPPPA
AGGGGGGGGGGGG                          A
AGGGGGGGGGGGGG                         A                                    
AGGGGGGGGGGGGg                         A
AGGGGGGGGGGGGG                         A                              
APPPPPPPPPPPPPP                        A
A                                      A
A                                      A
A                                      A
A                    PPPPPPPPPPPPPPPPPPA
A                    P    GGGGGGGGGGGGGA
A                    P      GGGGGGGGGGGA 
A                    P GGGGGGGGGGGGGGGGA
A                    PGGGGGGGGGGGGGGGGGA
A                                      A
A                                      A
A                                      A
A           GP                         A
A          GGP                         A
A         GGGP                         A
A        GGGGPPPPPPPPPPPP              A
A       GGGGGPGGGGGGGG                 A
A      GGGGGGPGGGGGGG                  A
A     GGGGGGGPGGGGGG                   A
AGGGGGGGGGGGGPGGGGGG                   A
AGGGGGGGGGGGGPPPPPPPPPPPPPPPPPPPPPPPPPPA
AGGGGGGGGGGGG                          A
AGGGGGGGGGGGGG                         A
AGGGGGGGGGGGGGG                        A
AGGGGGGGGGGGGGGG                       A
AGGGGGGGGGGGGGGGG                      A                                     
AAAAAAAAAAAAAAAAAAAAAAAAAAAAAAAAAAAAAAAA