AAAAAAAAAAAAAAAAAAAAAAAAAAAAAAAAAAAAAAAAAAAAAAAAAAAAAAAAAAAAAAAA
AAAAAAA              AAAAAAAAAAAAAAAAAAAAAAAAAAA               A
AAAAAAA              G                                         A
AAAAAAA      E       G                                GG       A
AAAAAAA              G                                GG       A
AAAAAAA              AAAAAAAAAAAAAAAAAAAAAAAAAAA               A
AAAAAAAAAAAAAAAAAAAAAAAAAAAAAAAAAAAAAAAAAAAAAAAA               A
A GGGGGGGGG                    GGGGGGGGGGGAAAAAAGGGGGGGGGGGGGGGA
A GGGG                         GGGGGGGGGGGAAAAAAGGGGGGGGGGGGGGGA
A GGG                          GGGGGGGGGGGAAAAAAGGGGGGGGGGGGGGGA
A G                            GGGGGGGGGGGAAAAAAGGGGGGGGGGGGGGGA
A                     AAAAAAAAA           AAAAAAGGGGGGGGGGGGGGGA
AGGGGGGGGGGGGGGGGGGGGGAAAAAAAAA           AAAAAAGGGGGGGGGGGGGGGA
A                     AAAAAAAAA           AAAAAAGGGGGGGGGGGGGGGA
A   GGG   GGGG   GGGGGAAAAAAAAA                                A
AGGG   GGG    GGG     AAAAAAAAA       GGG        GGG           A
A   GGG   GGGG   GGGGGAAAAAAAAA       GGG        GGG           A
AGGG   GGG    GGG     AAAAAAAAA       GGG        GGG           A
A                     AAAAAAAAA                                A
A                     AAAAAAAAAGGGGGGGGGGGGGGGGGGGGGGGGGGGGGGGGA
AGGGGGGGGGGGGGGGGGGGGGAAAAAAAAAAAAAAAAAAAAAAAAAAAAAAAAAAAAAAAAAA
AGGGGGGGGGGGGGGGGGGGGGAAAAAAAAAAAAAAAAAAAAAAAAAAAAAAAAAAAAAAAAAA
AGGGGGGGGGGGGGGGGGGGGGAAAAAAAAAAAAAAAAAAAAAAAAAAAAAAAAAAAAAAAAAA
A                       GG     GG                              A
A      GGGG              GG     GG     GGG         GGG         A
A      GGGG             GG     GG      GGG         GGG         A
A      GGGG              GG     GG     GGG         GGG         A
A                       GG     GG                              A
AAAAAAAAAAAAAAAAAAAAAAAAAAAAAAAAAAAAAAAAAAAAAGGGGGGGGGGGGGGGGGGA
AAAAAAAAAAAAAAAAAAAAAAAAAAAAAAAAAAAAAAAAAAAAAGGGGGGGGGGGGGGGGGGA
AAAAAAAAAAAAAAAAAAAAAAAAAAAAAAAAAAAAAAAAAAAAAGGGGGGGGGGGGGGGGGGA
AAAAAAAAAAAAAAAAAAAAAAAAAAAAAAAAAGGGGGGGGG                     A
AAAAAAAAAAAAAAAAAAAAAAAAAAAAAAAAAGGGGGGG                       A
AAAAAAAAAAAAAAAAAAAAAAAAAAAAAAAAAGGGGGGG            J          A
AAAAAAAAAAAAAAAAAAAAAAAAAAAAAAAAAGGGGGGGGG                     A
AAAAAAAAAAAAAAAAAAAAAAAAAAAAAAAAAAAAAAAAAAAAAAAAAAAAAAAAAAAAAAAA