AAAAAAAAAAAAAAAAAAAAAAAAAAAAAAAAAAAAAAAAAAAAAAAAAAAAAAAAAAAAAAAAAAAAAAAAAAAAAAAAAAAAAAAAAAAAAAAA
A                                                                                              A
A                                                                                              A
A                    J                                  G                                      A
A                    G                                  G                                      A
A                    G                                  G                                      A
A                    G                                  G                                      A
A                    G                                  G                                      A
A                    G                                  G                                      A
A                    G                                  G                                      A
A                    G                                  G                                      A
A                    G                                  G                                      A
A                    G                                  G                                      A
A                    G                                  G                                      A
A                    G                                  G                                      A
A                    G                                  G                                      A
A                    G                                  G                                      A
A                    G                                  G                                      A
A                    G                                  G                                      A
A                    G                                  G                                      A
A                    G                                  G                                      A
A                    G                                  G                                      A
A                    G                                  G                                      A
A                    G                                  G                                      A
A                    G                                  G                                      A
A                    G                                  G                                      A
A                    G                                  G                                      A
A                    G                                  G                                      A
A                    G                                  G                                      A
A                    G                                  G                                      A
A                    G                                  G                                      A
A                    G                                  G                                      A
A                    G                                  G                                      A
A                    G                                  G                                      A
A                    G                                  G                                      A
A                    G                                  G                                      A
A                    G                                  G                                      A
A                    G                                  G                                      A
A                    G                                  G                                      A
A                    G                                  G                                      A
A                    G                                  G                                      A
A                    G                                  G                                      A
A                    G                                  G                                      A
A                    G                                  G                                      A
A                    G                                  G                                      A
A                    G                                  G                                      A
A                    G                                  G                                      A
A                    G                                  G                                      A
A                    G                                  G                                      A
A                    G                                  G                                      A
A                    G                                  G                                      A
A                    G                                  G                                      A
A                    G                                  G                                      A
AAAAAAAAAAAAAAAAAAAAAAAAAAAAAAAAAAAAAAAAAAAAAAAAAAAAAAAAAAAAAAAAAAAAAAAAAAAAAAAAAAAAAAAAAAAAAAAA