AAAAAAAAAAAAAAAAAAAAAAAAAAAAAAAAAAAAAAAAAAAAAAAAAAAAAAAAAAAAAAAA
AGGGGGGGGGGGGGGGGGGGGGGGGGGGGGGGGGGGGGGGGGGGGGGGGGGGGGGGGGGGGGGA
A                                     G                        A
A       E            J    G                G                   A
A                         G                       G            A
A                              G                              GA
A                              G                              GA
APPPPPPPPPPPPPPPPPPPPPPPPPPPPPPGGGGGGGGGGGGGGGGGGGGGGGGGGGGGGGGA
AGGGGGGGGGGGGGGGGGGGGG         G                    GGGGGGGGGGGA
AGGGGGGGGGGGGGGGGG             G                  GGGGGGGGGGGGGA
AGGGGGGGGGGGGGGGGGGGGG                         GGGGGGGGGGGGGGGGA
AGGGGGGGGGGGGGGGGGGGGG                                        GA
A                    G             PPPPPPPPPPPPPPPPPPPPPPPPPPPPA
A                                GGGGGGGGGGGGGGGGGGGGGGGGGGGGGGA
AGGGGGGGGGGGGGGGGGGGGGGGGGGGG                                 GA
AGGGGGGGGGGGGGGGGGGGGGGGGGGGGGGG                              GA
APPPPPPPPPPPPPPPPPPPPPPPPPPPPPPGGGGGGGGGGGGGGGGGGGGGGGGGGGGGGGGA
AGGGGGGGGGGGGGGGGGGGGGGGGGGGGGGG                    GGGGGGGGGGGA
AGGGGGGGGGGGGGGGGGGGGGGGGGGGG                                 GA
A                                        G                    GA
A                              GGGGGGGGGGGGGGGGGGGGGGGGGGGGGGGGA
A                              G                              GA
A                    PPPPPPPPPPPPPPPPPPPPPPPPPPPPPPPPPPPPPPPPPPA
A                              GGGGGGGGGGGGGGGGGGGGGGGGGGGGGGGGA
A                              G GGGGGGGGGGGGGGGGGGGGGGGGGGGGGGA
A                              G                  GGGGGGGGGGGGGA
A                       G                      GGGGGGGGGGGGGGGGA
A                                                GGGGGGGGGGGGGGA
APPPPPPPPPPPPPPPPPPPPPPP           GGGGGGGGGGGGGGGGGGGGGGGGGGGGA
A                              P GGGGGGGGGGGGGGGGGGGGGGGGGGGGGGA
A                              PPPPPPPPPPPPPPPPPPPPPPPPPPPPPPPPA
A                              PGGGGGGGGGGGGGGGGGGGGGGGGGGGGGGGA
A                              P                  GGGGGGGGGGGGGA
A                       G                      GGGGGGGGGGGGGGGGA
AGGGGGGGGGGGGGGGGGGGGGGGGGGGGGGGGGGGGGGGGGGGGGGGGGGGGGGGGGGGGGGA
AAAAAAAAAAAAAAAAAAAAAAAAAAAAAAAAAAAAAAAAAAAAAAAAAAAAAAAAAAAAAAAA