AAAAAAAAAAAAAAAAAAAAAAAAAAAAAAAAAAAAAAAAAAAAAAAAAAAAAAAAAAAAAAAA
A  G           G                                               A
A                                     G                        A
A                        G                 G                   A
A                         G                       G            A
A                              G                              GA
A                              G                              GA
A                              GGGGGGGGGGGGGGGGGGGGGGGGGGGGGGGGA
A                              G                    GGGGGGGGGGGA
A                              G                  GGGGGGGGGGGGGA
A             G                                GGGGGGGGGGGGGGGGA
A                    G                                        GA
A                    G                                        GA
A                              GGGGGGGGGGGGGGGGGGGGGGGGGGGGGGGGA
A                              G                              GA
A                              G                              GA
A                              GGGGGGGGGGGGGGGGGGGGGGGGGGGGGGGGA
A                              G                    GGGGGGGGGGGA
A                              G                              GA
A                                        G                    GA
A                              GGGGGGGGGGGGGGGGGGGGGGGGGGGGGGGGA
A                              G                              GA
A                    G                                        GA
A                              GGGGGGGGGGGGGGGGGGGGGGGGGGGGGGGGA
A                              G                    GGGGGGGGGGGA
A                              G                  GGGGGGGGGGGGGA
A                       G                      GGGGGGGGGGGGGGGGA
A                                                GGGGGGGGGGGGGGA
A                                              GGGGGGGGGGGGGGGGA
A                              G                              GA
A                              GGGGGGGGGGGGGGGGGGGGGGGGGGGGGGGGA
A                              G                    GGGGGGGGGGGA
A                              G                  GGGGGGGGGGGGGA
A                       G                      GGGGGGGGGGGGGGGGA
A                                                GGGGGGGGGGGGGGA
AAAAAAAAAAAAAAAAAAAAAAAAAAAAAAAAAAAAAAAAAAAAAAAAAAAAAAAAAAAAAAAA