AAAAAAAAAAAAAAAAAAAAAAAAAAAAAAAAAAAAAAAAAAAAAAAAAAAA
A                                                  A
A                      J                           A
A                                                  A
A                                                  A
A                                                  A
A                                                  A
A                                                  A
A    G                         G                   A
A                                                  A
A                                                  A
A                                                  A
A    G                         G                   A
A                                                  A
A                                                  A
A                                                  A
A    G                         G                   A
A                                                  A
A                                                  A
A                                                  A
A    G                         G                   A
A                                                  A
A                                                  A
A                                                  A
A    G                         G                   A
A                                                  A
A                                                  A
A                                                  A
A    G                         G                   A
A                                                  A
A                                                  A
A                                                  A
A    G                         G                   A
A                                                  A
A                                                  A
A                                                  A
A    G                         G                   A
A                                                  A
A                                                  A
A                                                  A
A    G                         G                   A
A                                                  A
A                                                  A
A                                                  A
A    G                         G                   A
A                                                  A
A                                                  A
A                                                  A
A    G                         G                   A
A                                                  A
A                                                  A
A                                                  A
A    G                         G                   A
A                                                  A
A                                                  A
A                                                  A
A    G                         G                   A
A                                                  A
A                                                  A
A                                                  A
A    G                         G                   A
A                                                  A
A                                                  A
A                                                  A
A    G                         G                   A
A                                                  A
A                                                  A
A                                                  A
A    G                         G                   A
A                                                  A
A                                                  A
A                                                  A
A    G                         G                   A
A                                                  A
A                                                  A
A                                                  A
A    G                         G                   A
A                                                  A
A                                                  A
A                                                  A
A    G                         G                   A
A                                                  A
A                                                  A
A                                                  A
A    G                         G                   A
A                                                  A
A                                                  A
A                                                  A
A    G                         G                   A
A                                                  A
A                                                  A
A                                                  A
A                                                  A
A                                                  A
A                                                  A
AAAAAAAAAAAAAAAAAAAAAAAAAAAAAAAAAAAAAAAAAAAAAAAAAAAA